00 00 00 00 00 00 00 00 00 00 00 00 00 00 00 00 00 00 00 00 00
00 00 00 00 00 00 00 00 00 00 00 00 00 00 00 00 00 00 00 00 00
09 03 03 03 03 03 03 03 03 03 14 03 03 03 03 03 03 03 03 03 10  
04 02 01 01 01 01 01 01 01 01 04 01 01 01 01 01 01 01 01 02 04
04 01 09 10 01 09 03 03 10 01 04 01 09 03 03 10 01 09 10 01 04
04 01 12 11 01 12 03 03 11 01 07 01 12 03 03 11 01 12 11 01 04
04 01 01 01 01 01 01 01 01 01 01 01 01 01 01 01 01 01 01 01 04
04 01 08 05 01 06 01 08 03 03 14 03 03 05 01 06 01 08 05 01 04
04 01 01 01 01 04 01 01 01 01 04 01 01 01 01 04 01 01 01 01 04
12 03 03 10 01 16 03 03 05 00 07 00 08 03 03 15 01 09 03 03 11
00 00 00 04 01 04 00 00 00 00 00 00 00 00 00 04 01 04 00 00 00
03 03 03 11 01 07 00 17 20 20 25 20 20 18 00 07 01 12 03 03 03
00 00 00 00 01 00 00 24 00 00 00 00 00 19 00 00 01 00 00 00 00
03 03 03 10 01 06 00 23 22 22 22 22 22 21 00 06 01 09 03 03 03
00 00 00 04 01 04 00 00 00 00 00 00 00 00 00 04 01 04 00 00 00
09 03 03 11 01 07 00 08 03 03 14 03 03 05 00 07 01 12 03 03 10
04 01 01 01 01 01 01 01 01 01 04 01 01 01 01 01 01 01 01 01 04
04 01 08 10 01 08 03 03 05 01 07 01 08 03 03 05 01 09 05 01 04
04 01 01 04 01 01 01 01 01 01 01 01 01 01 01 01 01 04 01 01 04
16 05 01 07 01 06 01 08 03 03 14 03 03 05 01 06 01 07 01 08 15
04 01 01 01 01 04 01 01 01 01 04 01 01 01 01 04 01 01 01 01 04
04 01 08 03 03 13 03 03 05 01 07 01 08 03 03 13 03 03 05 01 04
04 02 01 01 01 01 01 01 01 01 01 01 01 01 01 01 01 01 01 02 04
12 03 03 03 03 03 03 03 03 03 03 03 03 03 03 03 03 03 03 03 11
00 00 00 00 00 00 00 00 00 00 00 00 00 00 00 00 00 00 00 00 00